10 10
##########
# ..#  ###
# ..# $###
#  ##    #
## $   $ #
## ##  ###
##   $####
####  ####
####+ ####
##########
