7 6
######
# +###
# .*##
# *  #
# $  #
##  ##
######
