12 7
#######
##   ##
#    +#
#$#####
#  ...#
# $ $ #
#...$ #
#### ##
#     #
# $$  #
##   ##
#######
