7 9
#########
##     ##
#    $ +#
# $.$$. #
# $..$. #
# $..$. #
#########
