6 7
#######
#  ####
# . . #
# $$#+#
##    #
#######
