8 8
########
#  . . #
#    # #
## # # #
##  $  #
##  $+ #
##     #
########
