6 8
########
##  ####
##  $  #
# +..$ #
# $ .  #
########
