5 10
##########
#        #
#  $  .+ #
#        #
##########
