6 8
########
##  ####
##  $  #
# + .$ #
# $ .  #
########
