13 8
########
##    ##
#  ## ##
# #..  #
#   . +#
# $## ##
## #  ##
## $ ###
#  $####
#   ####
#   ####
#  #####
########
