10 8
########
#    ###
#@$  ###
#### ###
##   ###
##    ##
#  ##. #
#      #
#####  #
########