6 8
########
#      #
# .  $+#
#      #
#####  #
########
