7 6
######
# +###
# . ##
#    #
# $  #
##  ##
######
