6 9
#########
##  #   #
#.$.  $ #
# #  ## #
# @$.$. #
#########