6 9
#########
#  #   .#
#@$ $   #
# $ ##..#
#   #####
#########